1111111111111111111111
1010001011101110101111
1010101111111111111011
1000000P00000000000011
1011101011111010111011
10111110111010100N1011
1000111011111010111011
1010101011111110101011
11101110100N1010111011
1000CNNC1010100000N0E1
1111111111111111111111