111111111111111111111
1E0000001110000111001
1000000011000N0000C01
10001000100000000C111
10C01000000000000P111
111111111111111111111