1111111111111111111
100N000000C000000E1
100N000000000000001
1000000000000000001
10000C0C0C0C0000001
100N0C0C0C0C00N0001
10000C0C0C0C0000001
1N000C0C0C0C000N001
100N0C0C0P0C0000011
10000C0C0C0C000N001
10000C0C0C0C00000E1
1111111111111111111